tachment" | "inline" | "unspecified";
type PublicKeyCredentialType = "public-key";
type PushEncryptionKeyName = "auth" | "p256dh";
type PushPermissionState = "denied" | "granted" | "prompt";
type RTCBundlePolicy = "balanced" | "max-bundle" | "max-compat";
type RTCDataChannelState = "closed" | "closing" | "connecting" | "open";
type RTCDegradationPreference = "balanced" | "maintain-framerate" | "maintain-resolution";
type RTCDtlsTransportState = "closed" | "connected" | "connecting" | "failed" | "new";
type RTCIceCandidateType = "host" | "prflx" | "relay" | "srflx";
type RTCIceComponent = "rtcp" | "rtp";
type RTCIceConnectionState = "checking" | "closed" | "completed" | "connected" | "disconnected" | "failed" | "new";
type RTCIceCredentialType = "password";
type RTCIceGathererState = "complete" | "gathering" | "new";
type RTCIceGatheringState = "complete" | "gathering" | "new";
type RTCIceProtocol = "tcp" | "udp";
type RTCIceTcpCandidateType = "active" | "passive" | "so";
type RTCIceTransportPolicy = "all" | "relay";
type RTCIceTransportState = "checking" | "closed" | "completed" | "connected" | "disconnected" | "failed" | "new";
type RTCPeerConnectionState = "closed" | "connected" | "connecting" | "disconnected" | "failed" | "new";
type RTCPriorityType = "high" | "low" | "medium" | "very-low";
type RTCRtcpMuxPolicy = "require";
type RTCRtpTransceiverDirection = "inactive" | "recvonly" | "sendonly" | "sendrecv" | "stopped";
type RTCSdpType = "answer" | "offer" | "pranswer" | "rollback";
type RTCSignalingState = "closed" | "have-local-offer" | "have-local-pranswer" | "have-remote-offer" | "have-remote-pranswer" | "stable";
type RTCStatsIceCandidatePairState = "failed" | "frozen" | "in-progress" | "inprogress" | "succeeded" | "waiting";
type RTCStatsType = "candidate-pair" | "certificate" | "codec" | "csrc" | "data-channel" | "inbound-rtp" | "local-candidate" | "media-source" | "outbound-rtp" | "peer-connection" | "remote-candidate" | "remote-inbound-rtp" | "remote-outbound-rtp" | "track" | "transport";
type ReadyState = "closed" | "ended" | "open";
type RecordingState = "inactive" | "paused" | "recording";
type ReferrerPolicy = "" | "no-referrer" | "no-referrer-when-downgrade" | "origin" | "origin-when-cross-origin" | "same-origin" | "strict-origin" | "strict-origin-when-cross-origin" | "unsafe-url";
type RemotePlaybackState = "connected" | "connecting" | "disconnected";
type RequestCache = "default" | "force-cache" | "no-cache" | "no-store" | "only-if-cached" | "reload";
type RequestCredentials = "include" | "omit" | "same-origin";
type RequestDestination = "" | "audio" | "audioworklet" | "document" | "embed" | "font" | "frame" | "iframe" | "image" | "manifest" | "object" | "paintworklet" | "report" | "script" | "sharedworker" | "style" | "track" | "video" | "worker" | "xslt";
type RequestMode = "cors" | "navigate" | "no-cors" | "same-origin";
type RequestRedirect = "error" | "follow" | "manual";
type ResidentKeyRequirement = "discouraged" | "preferred" | "required";
type ResizeObserverBoxOptions = "border-box" | "content-box" | "device-pixel-content-box";
type ResizeQuality = "high" | "low" | "medium" | "pixelated";
type ResponseType = "basic" | "cors" | "default" | "error" | "opaque" | "opaqueredirect";
type ScrollBehavior = "auto" | "smooth";
type ScrollLogicalPosition = "center" | "end" | "nearest" | "start";
type ScrollRestoration = "auto" | "manual";
type ScrollSetting = "" | "up";
type SecurityPolicyViolationEventDisposition = "enforce" | "report";
type SelectionMode = "end" | "preserve" | "select" | "start";
type ServiceWorkerState = "activated" | "activating" | "installed" | "installing" | "parsed" | "redundant";
type ServiceWorkerUpdateViaCache = "all" | "imports" | "none";
type ShadowRootMode = "closed" | "open";
type SlotAssignmentMode = "manual" | "named";
type SpeechSynthesisErrorCode = "audio-busy" | "audio-hardware" | "canceled" | "interrupted" | "invalid-argument" | "language-unavailable" | "network" | "not-allowed" | "synthesis-failed" | "synthesis-unavailable" | "text-too-long" | "voice-unavailable";
type TextTrackKind = "captions" | "chapters" | "descriptions" | "metadata" | "subtitles";
type TextTrackMode = "disabled" | "hidden" | "showing";
type TouchType = "direct" | "stylus";
type TransferFunction = "hlg" | "pq" | "srgb";
type UserVerificationRequirement = "discouraged" | "preferred" | "required";
type VideoFacingModeEnum = "environment" | "left" | "right" | "user";
type VisibilityState = "hidden" | "visible";
type WebGLPowerPreference = "default" | "high-performance" | "low-power";
type WorkerType = "classic" | "module";
type XMLHttpRequestResponseType = "" | "arraybuffer" | "blob" | "document" | "json" | "text";
